1111111111111111111111111111111111
1E000000000000CT00000CT00000T00001
1T10T10100100000101001000000010101
1010010010101010001001000000010101
1P0000000C00C000000000000000000TC1
1111111111111111111111111111111111
